98 98 98 98 98 98 98 98 98 98 98 98 98 98 98 98 98 98 98 98 98 98 98 98 98 98 98 98 98 98 98 98 98 98 98 98 98 98 98 98 98 98 98 98 98 98 98 98 98 98 
98 98 98 98 98 98 98 98 98 98 98 98 98 98 98 98 98 98 98 98 98 98 98 98 98 98 98 98 98 98 98 98 98 98 98 98 98 98 98 98 98 98 98 98 98 98 98 98 98 98 
98 98 98 98 98 98 98 98 98 98 98 98 98 98 98 98 98 98 98 98 99 18 18 18 18 18 99 98 98 98 98 98 98 98 98 98 98 98 98 98 98 98 98 98 98 98 98 98 98 98 
98 98 98 98 98 98 98 98 98 98 98 98 98 98 98 98 98 98 98 98 18 18 18 18 18 18 18 98 98 98 98 98 98 98 98 98 98 98 98 98 98 98 98 98 98 98 98 98 98 98 
98 98 98 98 98 98 98 98 98 98 98 98 98 98 98 98 98 98 98 98 18 18 18 18 18 18 18 98 98 98 98 98 98 98 98 98 98 98 98 98 98 98 98 98 98 98 98 98 98 98 
98 98 98 98 98 98 98 98 98 98 98 98 98 98 98 98 98 98 98 98 18 18 18 18 18 18 18 98 98 98 98 98 98 98 98 98 98 98 98 98 98 98 98 98 98 98 98 98 98 98 
98 98 98 98 98 98 98 98 32 32 32 32 32 98 98 98 98 98 98 98 98 18 18 18 18 18 98 98 98 98 98 98 98 98 98 98 98 98 98 98 98 98 98 98 98 98 98 98 98 98 
98 98 98 98 98 98 98 98 32 3 3 3 32 98 98 98 98 98 98 98 99 99 99 3 99 99 99 98 98 98 98 98 98 99 3 3 3 3 3 3 3 98 98 98 98 98 98 98 98 98 
98 98 98 98 98 98 98 98 32 3 3 3 32 98 98 98 98 98 98 98 98 99 99 99 99 99 98 98 98 98 98 98 98 98 3 3 3 3 3 3 3 3 98 98 98 98 98 98 98 98 
98 98 98 98 98 98 98 98 32 3 3 3 32 98 98 98 98 98 98 98 98 98 99 99 99 98 98 98 98 98 98 98 98 98 3 3 3 3 3 3 3 3 98 98 98 98 98 98 98 98 
98 98 98 98 98 98 98 98 32 3 3 3 32 98 98 98 98 98 98 98 98 98 98 3 98 98 98 98 98 98 98 98 98 98 3 3 3 3 3 3 3 3 98 98 98 98 98 98 98 98 
98 98 98 98 98 98 98 98 32 32 99 32 32 98 98 98 98 98 98 98 98 98 98 3 98 98 98 98 98 98 98 98 98 98 3 3 3 3 3 3 3 3 98 98 98 98 98 98 98 98 
98 98 98 98 98 98 98 98 98 98 99 98 98 98 98 98 98 98 98 98 98 98 98 3 98 98 98 98 98 98 98 98 98 98 98 3 3 3 3 3 3 98 98 98 98 98 98 98 98 98 
98 98 98 98 98 98 98 98 98 98 99 98 98 98 98 98 98 98 98 98 98 98 98 3 98 98 98 98 98 98 98 98 98 98 98 98 98 98 3 98 98 98 98 98 98 98 98 98 98 98 
98 98 98 98 98 98 98 98 98 98 99 98 98 98 98 98 98 98 98 98 98 98 98 3 98 98 98 98 98 98 98 98 98 98 98 98 98 98 3 98 98 98 98 98 98 98 98 98 98 98 
98 98 98 98 98 98 98 98 98 98 99 98 98 98 98 98 98 98 98 98 98 98 98 3 98 98 98 98 98 98 98 98 98 98 98 98 98 98 3 98 98 98 98 98 98 98 98 98 98 98 
98 98 98 98 98 98 98 98 99 99 99 98 98 98 98 98 98 98 98 98 98 98 98 3 98 98 98 98 98 98 98 98 98 98 98 98 98 98 3 98 98 98 98 98 98 98 98 98 98 98 
98 98 98 98 98 98 98 98 99 98 98 98 98 98 98 98 98 98 98 98 98 98 98 3 98 98 98 98 98 98 98 98 98 98 98 98 98 98 3 98 98 98 98 98 98 98 98 98 98 98 
98 98 98 98 98 98 98 98 99 98 98 98 98 98 98 98 98 98 98 98 98 98 99 3 99 98 98 98 98 98 98 98 98 98 98 98 3 3 3 98 98 98 98 98 98 98 98 98 98 98 
98 98 98 98 98 98 98 98 99 98 98 98 98 98 98 98 98 98 98 98 98 99 99 3 99 99 98 98 98 98 98 98 98 98 98 98 3 98 98 98 98 98 98 98 98 98 98 98 98 98 
98 98 98 98 98 98 98 98 99 98 98 98 98 98 98 98 98 98 98 98 99 99 99 3 99 99 99 98 98 98 98 98 98 98 98 3 3 98 98 98 98 98 98 98 98 98 98 98 98 98 
98 98 98 98 98 98 98 98 99 98 98 98 3 3 3 3 3 3 3 3 3 3 3 3 3 3 3 3 3 3 3 3 3 3 3 3 3 98 98 98 98 98 98 98 98 98 98 98 98 98 
98 98 98 98 98 98 98 98 99 98 98 98 99 98 98 98 98 98 98 98 99 99 99 3 99 99 99 98 98 98 98 98 98 98 98 98 3 98 98 98 98 98 98 98 98 98 98 98 98 98 
98 98 98 98 98 98 98 98 99 98 98 98 99 98 98 98 98 98 98 98 98 99 99 3 99 99 98 98 98 98 98 98 98 98 98 98 3 98 98 98 98 98 98 98 98 98 98 98 98 98 
98 98 98 98 98 98 98 98 99 98 98 98 99 98 98 98 98 98 98 98 98 98 99 3 99 98 98 98 98 98 98 98 98 98 98 98 3 98 98 98 98 98 98 98 98 98 98 98 98 98 
98 98 98 98 98 98 98 98 99 98 98 98 99 99 99 98 98 98 98 98 98 98 98 3 98 98 98 98 98 98 98 98 98 98 98 98 3 98 98 98 98 98 98 98 98 98 98 98 98 98 
98 98 98 98 98 98 98 98 99 98 98 98 98 98 99 98 98 98 98 98 98 98 98 3 98 98 98 98 98 98 98 98 98 98 98 98 3 98 98 98 98 98 98 98 98 98 98 98 98 98 
98 98 98 98 98 98 98 98 99 98 98 98 98 98 99 98 98 98 98 98 98 98 98 3 98 98 98 99 98 98 98 98 98 98 98 99 3 98 98 98 98 98 98 98 98 98 98 98 98 98 
98 98 98 98 98 98 98 98 99 98 98 98 98 98 99 98 98 98 98 98 98 98 98 3 98 98 98 98 98 98 99 98 98 98 98 98 3 98 98 98 98 98 98 98 98 98 98 98 98 98 
98 98 98 98 98 98 98 98 99 99 99 99 99 99 99 98 98 98 98 98 98 98 98 3 98 98 98 98 98 98 99 98 98 98 98 98 3 98 98 98 98 98 98 98 98 98 98 98 98 98 
98 98 98 98 98 98 98 98 99 99 99 99 99 99 99 98 98 98 98 98 98 98 98 3 98 98 98 98 98 98 98 98 98 98 98 98 99 98 98 98 98 98 98 98 98 98 98 98 98 98 
98 98 98 98 98 98 98 98 99 99 99 99 99 99 99 98 98 98 98 98 98 98 98 3 98 98 98 98 98 98 98 98 98 98 98 99 99 99 98 98 98 98 98 98 98 98 98 98 98 98 
98 98 98 98 98 98 98 98 99 99 99 99 99 99 99 98 98 98 98 98 98 98 98 3 98 98 98 98 98 98 98 98 98 98 98 99 99 99 98 98 98 98 98 98 98 98 98 98 98 98 
98 98 98 98 98 98 98 98 99 99 99 99 99 99 99 98 98 98 98 98 98 98 98 3 98 98 98 98 98 98 98 98 98 98 98 99 99 99 98 98 98 98 98 98 98 98 98 98 98 98 
98 98 98 98 98 98 98 98 99 99 99 99 99 99 99 98 98 98 98 98 98 98 98 3 98 98 98 98 98 98 98 98 98 98 98 99 99 99 98 98 98 98 98 98 98 98 98 98 98 98 
98 98 98 98 98 98 98 98 98 98 98 98 98 98 98 98 98 98 98 98 98 98 98 3 98 98 98 98 98 98 98 98 98 98 98 99 99 99 98 98 98 98 98 98 98 98 98 98 98 98 
98 98 98 98 98 98 98 98 98 98 98 98 98 98 98 98 98 98 98 99 99 99 99 99 99 99 99 98 98 98 98 98 98 98 99 99 99 99 99 98 98 98 98 98 98 98 98 98 98 98 
98 98 98 98 98 98 98 98 98 98 98 98 98 98 98 98 98 98 99 99 99 99 99 99 99 99 99 99 98 98 99 98 98 99 99 99 99 99 99 98 98 98 98 98 98 98 98 98 98 98 
98 98 98 98 98 98 98 98 98 98 98 98 98 98 98 98 98 98 99 99 99 99 99 99 99 99 99 99 98 98 98 98 99 99 99 99 99 99 99 98 98 98 98 98 98 98 98 98 98 98 
98 98 98 98 98 98 98 98 98 98 98 98 98 99 98 98 98 98 99 99 99 99 99 99 99 99 99 99 99 98 98 98 99 99 99 99 99 98 99 98 98 98 98 98 98 98 98 98 98 98 
98 98 98 98 98 98 98 98 98 98 98 98 98 98 98 98 98 98 99 99 99 99 99 99 99 99 99 99 99 99 99 99 99 99 98 99 99 99 99 98 98 98 98 98 98 98 98 98 98 98 
98 98 98 98 98 98 98 98 98 98 98 98 98 99 98 98 98 98 98 99 99 99 99 99 99 99 99 98 98 98 98 99 99 99 99 99 99 99 99 98 98 98 98 98 98 98 98 98 98 98 
98 98 98 98 98 98 98 98 98 98 98 98 98 98 98 98 98 98 98 98 99 99 99 99 99 99 98 98 98 98 98 99 99 98 99 99 98 99 99 98 98 98 98 98 98 98 98 98 98 98 
98 98 98 98 98 98 98 98 98 98 98 98 98 98 98 98 98 98 98 98 98 98 98 98 98 98 98 98 98 98 98 98 99 99 99 99 99 99 98 98 98 98 98 98 98 98 98 98 98 98 
98 98 98 98 98 98 98 98 98 98 98 98 98 98 98 98 98 98 98 98 98 98 98 98 98 98 98 98 98 98 98 98 98 98 98 98 98 98 98 98 98 98 98 98 98 98 98 98 98 98 
98 98 98 98 98 98 98 98 98 98 98 98 98 98 98 98 98 98 98 98 98 98 98 98 98 98 98 98 98 98 98 98 98 98 98 98 98 98 98 98 98 98 98 98 98 98 98 98 98 98 
98 98 98 98 98 98 98 98 98 98 98 98 98 98 98 98 98 98 98 98 98 98 98 98 98 98 98 98 98 98 98 98 98 98 98 98 98 98 98 98 98 98 98 98 98 98 98 98 98 98 
98 98 98 98 98 98 98 98 98 98 98 98 98 98 98 98 98 98 98 98 98 98 98 98 98 98 98 98 98 98 98 98 98 98 98 98 98 98 98 98 98 98 98 98 98 98 98 98 98 98 
98 98 98 98 98 98 98 98 98 98 98 98 98 98 98 98 98 98 98 98 98 98 98 98 98 98 98 98 98 98 98 98 98 98 98 98 98 98 98 98 98 98 98 98 98 98 98 98 98 98 
98 98 98 98 98 98 98 98 98 98 98 98 98 98 98 98 98 98 98 98 98 98 98 98 98 98 98 98 98 98 98 98 98 98 98 98 98 98 98 98 98 98 98 98 98 98 98 98 98 98 